理髪店	りはつてん
美容院	びよういん
世話	せわ
刈る	かる
手入れ	ていれ
切る	きる
パーマ	パーマ
主人	しゅじん
剃る	そる
数人	すうにん
ソファー	ソファー
腰掛ける	こしかける
順番	じゅんばん
オーバー	オーバー
着せる	きせる
ブラシ	ブラシ
チップ	チップ
剃刀	かみそり
頬	ほほ
顎	あご
泡	あわ
塗り付ける	ぬりつける
安上がり	やすあがり
番	ばん
刈り上がる	かりあがる
散髪	さんぱつ
お待ち遠様	おまちどおさま
鈴木良子	すずきりょうこ
鏡	かがみ
就く	つく
髪型	かみがた
シャンプー	シャンプー
ヘアスタイルー	ヘアスタイルー
指差す	ゆびさす
染める	そめる
髪の毛	かみのけ
大通り	おおどおり
おじさん	おじさん
朗らか	ほがらか
黙る	だまる
巻く	まく
鋏	はさみ
櫛	くし
眠る	ねむる
醒める	さめる
付ける	つける
分ける	わける
肩	かた
揉む	もむ
払う	はらう
外	そと
郵便局	ゆうびんきょく
葉書	はがき
宛名	あてな
位置	いち
表書き	おもてがき
封筒	ふうとう
上部	じょうぶ
書き入れる	かきいれる
書き込む	かきこむ
左上	ひだりうえ
隅	すみ
差し出し人	さしだしにん
氏名	しめい
都道府県	とどうふけん
速達	そくたつ
郵便物	ゆうびんぶつ
届ける	とどける
料金	りょうきん
加算	かさん
書留	かきとめ
宛先	あてさき
届く	とどく
損害	そんがい
賠償	ばいしょう
現金	げんきん
受取り	うけとり
保管	ほかん
郵便振替	ゆうびんふりかえ
同様	どうよう
水道	すいどう
電気	でんき
ガス	ガス
公共料金	こうきょうりょうきん
他府県	たふけん
地域	ちいき
局員	きょくいん
航空便	こうくうびん
受け取る	うけとる
量る	はかる
小包み	こづつみ
振込	ふりこみ
計算	けいさん
合計	ごうけい
郵便切手	ゆうびんきって
考え出す	かんがえだす
取扱	とりあつかい
それまで	それまで
せっかく	せっかく
ところが	ところが
首都	しゅと
ロンドン	ロンドン
目方	めかた
力を尽くす	ちからをつくす
中	じゅう
埃	ほこり
科学的	かがくてき
汚れ方	よごれかた
舞い上がる	まいあがる
沈下	ちんか
平均	へいきん
グラム	グラム
クレンザーブラシ	クレンザーブラシ
スチルーウルー	スチルーウルー
物理的	ぶつりてき
洗剤	せんざい
溶剤	ようざい
化学的	かがくてき
鉄	てつ
細い	ほそい
削る	けずる
太さ	ふとさ
汚れ落とし	よごれおとし
有効	ゆうこう
千切る	ちぎる
容器	ようき
吉田	よしだ
張英	ちょうえい
分担	ぶんたん
掃除機	そうじき
拭く	ふく
雑巾	ぞうきん
流し	ながし
束子	たわし
擦る	こする
何時の間にか	いつのまにか
お昼	おひる
あら	あら
道具	どうぐ
場所	ばしょ
汚れる	よごれる
バケツ	バケツ
放課後	ほうかご
後輩	こうはい
モップ	モップ
動かす	うごかす
端	はし
自然	しぜん
国土	こくど
必ずしも	かならずしも
かなり	かなり
大国	たいこく
スウエーデン	スウエーデン
巨大国	きょだいこく
東北	とうほく
西南	せいなん
細長い	ほそながい
列島	れっとう
海岸線	かいがんせん
山地	さんち
火山地	かざんち
火山	かざん
活火山	かっかざん
低地	ていち
大部分	だいぶぶん
集中	しゅうちゅう
高温	こうおん
地域的	ちいきてき
太平洋	たいへいよう
日本海	にほんかい
諸島	しょとう
目立つ	めだつ
経済的	けいざいてき
鉱物	こうぶつ
資源	しげん
災害	さいがい
地震	じしん
台風	たいふう
火事	かじ
名物	めいぶつ
曇る	くもる
風	かぜ
吹く	ふく
様々	さまざま
深い	ふかい
傘	かさ
見上げる	みあげる
遠足	えんそく
照る照る坊主	てるてるぼうず
からりと	からりと
晴れ上がるる	はれあがる
爽やか	さわやか
じめじめ	じめじめ
滅入る	めいる
胃腸	いちょう
単に	たんに
気を配る	きをくばる
農家	のうか
種蒔き	たねまき
肥料	ひりょう
作物	さくもつ
成長	せいちょう
日照り	ひでり
枯れる	かれる
実る	みのる
風水害	ふうすいがい
遭う	あう
漁業	ぎょぎょう
携わる	たずさわる
荒れる	あれる
港	みなと
滅多に	めったに
あんな	あんな
嵐	あらし
辺	へん
墓参り	はかまいり
武	たけし
江ノ島	えのしま
次に	つぎに
沖縄	おきなわ
梅雨	つゆ
空模様	そらもよう
中国	ちゅうごく
近畿	きんき
中部	ちゅうぶ
関東	かんとう
東北	とうほく
南部	なんぶ
小雨	こさめ
確率	かくりつ
神奈川	かながわ
千葉	ちば
埼玉	さいたま
栃木	とちぎ
茨城	いばらき
群馬	ぐんま
日中	にっちゅう
最高	さいこう
最低	さいてい
各地	かくち
後	のち
朝晩	あさばん
一時	いちじ
より	より
にわか雨	にわかあめ
がち	がち
プラスチック	プラスチック
製	せい
入れ換え	いれかえ
使い捨	つかいすて
手軽さ	てがるさ
画質	がしつ
歓迎	かんげい
急伸	きゅうしん
出荷	しゅっか
割	わり
コニカ	コニカ
コダック	コダック
三菱製紙	みつびしせいし
松下電器	まつしたでんき
シェア	シェア
出し入れ	だしいれ
手間	てま
纏める	まとめる
出席者	しゅっせきしゃ
気にする	きにする
この辺	このへん
取り出す	とりだす
取り上げる	とりあげる
シャッター	シャッター
フラッシュ	フラッシュ
ファインダー	ファインダー
覗く	のぞく
で	で
レバー	レバー
取り替える	とりかえる
安心	あんしん
影	かげ
寄る	よる
下りる	おりる
機種	きしゅ
今のところ	いまのところ
頭が上がらない	あたまがあがらない
去る	さる
いとこ	いとこ
則ちゃん	のりちゃん
前日	ぜんじつ
口々	くちぐち
落ち着く	おちつく
嫁	よめ
飛り出す	とりだす
かんざし	かんざし
パッ	パッ
フラッシュをたく	フラッシュをたく
床の間	とこのま
向く	むく
名	めい
カメラマン	カメラマン
冷やかす	ひやかす
撮影	さつえい
保証	ほしょう
済み	ずみ
婿	むこ
汗	あせ
慌てる	あわてる
大声	おおごえ
一巻の終わり	いっかんのおわり
空回り	からまわり
何と	なんと
詫び	わび
ぼそぼそ	ぼそぼそ
がっかり	がっかり
とうとう	とうとう
節をつける	ふしをつける
御免	ごめん
逃げ出す	にげだす
謎々	なぞなぞ
自分	じぶん
大正	たいしょう
謎	なぞ
謎のかけっこ	なぞのかけっこ
生徒	生徒
審判	しんぱん
競争	きょうそう
難問	なんもん
そうそう	そうそう
かち合う	かちあう
大笑い	おおわらい
柴	しば
紫	むらさき
点	てん
糸	いと
素朴	そぼく
少女	しょうじょ
下火	したび
クイズ	クイズ
空白	くうはく
一種	いっしゅ
解く	とく
概ね	おおむね
真面	まとも
ふざける	ふざける
頓智	とんち
年子	としこ
ひろし(寛、宏、広)	ひろし
鳥小屋	とりごや
春夫	はるお
鶏	にわとり
生む	うむ
雛	ひよこ
象	ぞう
王様	おうさま
一頭	いっとう
大騒ぎ	おおさわぎ
役人	やくにん
さっそく	さっそく
秤	はかり
申し出る	もうしでる
掲示	けいじ
誰一人	だれひとり
度々	たびたび
催促	さいそく
沈む	しずむ
見物人	けんぶつにん
じっと	じっと
別	べつ
外側	そとがわ
下ろす	おろす
石	いし
積む	つむ
体力	たいりょく
ぱちぱち	ぱちぱち
委員会	いいんかい
川村	かわむら
利く	きく
目標	もくひょう
班	はん
一班	いっぱん
班長	はんちょう
鉄棒	てつぼう
前回り	まえまわり
池田	いけだ
谷口	たにぐち
不得意	ふとくい
小山	こやま
大西	おおにし
案	あん
木下	きのした
登り棒	のぼりぼう
励み	はげみ
中休み	なかやすみ
平気	へいき
登り切る	のぼりきる
応じる	おうじる
グラフ	グラフ
両方	りょうほう
記録	きろく
付け加える	つけくわえる
競走	きょうそう
公民館	こうみんかん
一気に	いっきに
和人	かずと
追い抜く	おいぬく
校庭	こうてい
一週	いっしゅう
ゴール	ゴール
貯える	たくわえる
出し切る	だしきる
縺れる	もつれる
正一	しょういち
ラスト	ラスト
必死	ひっし
一息	ひといき
風景	ふうけい
目に入る	めにはいる
ワーワー	ワーワー
声援	せいえん
響く	ひびく
食いしばる	くいしばる
絞り出す	しぼりだす
肩で息をする	かたでいきをする
追い込み	おいこみ
はあはあ	はあはあ
息を弾む	いきをはずむ
一歩	いっぽ
一位	いちい
途切れ途切れ	とぎれとぎれ
棒	ぼう
支える	ささえる
座り込む	すわりこむ
ずきんずきん	ずきんずきん
かっかと	かっかと
火照る	ほてる
いり乱れる	いりみだれる
ゴールイン	ゴールイン
平川	ひらかわ
紙切れ	かみきれ
一遍に	いっぺんに
さあっと	さあっと
飛び去る	とびさる
大空	おおぞら
精一杯	せいいっぱい
叫ぶ	さけぶ
要点	ようてん
順序	じゅんじょ
事柄	ことがら
結ぶ	むすぶ
間を置く	まをおく
強める	つよめる
聞き落とす	ききおとす
活用	かつよう
ひろこ	ひろこ
ほう	ほう
どきどき	どきどき
纏まる	まとまる
観察	かんさつ
心細い	こころぼそい
きちんと	きちんと
スケッチ	スケッチ
表	ひょう
それそれ	それそれ
鞭	むち
取り越し苦労	とりこしくろう
恥ずかしい	はずかしい
その内に	そのうちに
思いきって	おもいきって
ぐんと	ぐんと
成り立つ	なりたつ
大昔	おおむかし
手軽	てがる
そうして	そうして
貝殻	かいがら
貴重品	きちょうひん
稲	いね
説	せつ
武士	ぶし
名残	なごり
金属	きんぞく
価値	かち
壊れる	こわれる
分量	ぶんりょう
持ち運ぶ	もちはこぶ
凡そ	およそ
元明天皇	げんめいてんのう
銀	ぎん
銅	どう
銀貨	ぎんか
銅貨	どうか
金貨	きんか
預金	よきん
小切手	こぎて
手元	てもと
経済学	けいざいがく
学問	がくもん
議題	ぎだい
事前	じぜん
巡らす	めぐらす
議長	ぎちょう
発言	はつげん
公平	こうへい
適切	てきせつ
判断	はんだん
議事	ぎじ
建設的	けんせつてき
自ら	みずから
差し控える	さしひかえる
受け止める	うけとめる
断る	ことわる
意図	いと
明らか	あきらか
予告	よこく
持ち方	もちかた
委員	いいん
谷川	たにがわ
立ち消え	たちぎえ
上級	じょうきゅう
粗筋	あらすじ
大田	おおた
増やす	ふやす
野村	のむら
高木	たかぎ
北川	きたがわ
その都度	そのつど
次回	じかい
養う	やしなう
定期的	ていきてき
向上	こうじょう
石原	いしはら
たっぷり	たっぷり
紙芝居	かみしばい
試み	こころみ
展示	てんじ
祭典	さいてん
有難い	ありがたい
クラス会	クラスかい
通知	つうち
春休み	はるやすみ
間近い	まぢかい
スプロト	スプロト
帰り道	かえりみち
偶然	ぐうぜん
グラプ	グラプ
相変わらず	あいかわらず
再会	さいかい
親しげ	したしげ
肩を並べる	かたをならべる
うわさ話	うわさばなし
積もる	つもる
尽きる	つきる
世話役	せわやく
暮れる	くれる
暗い	くらい
心当たり	こころあたり
交渉	こうしょう
招待状	しょうたいじょう
日一日と	ひいちにちと
増す	ます
試験期	しけんき
存じる	ぞんじる
思い出話	おもいでばなし
そのおり	そのおり
昨年	さくねん
来たる	きたる
田村屋	たむらや
一同	いちどう
大田新作	おおたしんさく
イソップ	イソップ
物語	ものがたり
狐	きつね
井戸	いど
落ちる	おちる
どうしても	どうしても
渇く	かわく
山羊	やぎ
見付ける	みつける
褒め立てる	ほめたてる
収まる	おさまる
思い付く	おもいつく
前足	まえあし
突っ張る	つっぱる
角	つの
やる	やる
背中	せなか
引き上がる	ひきあがる
飛び上がる	とびあがる
踏み台	ふみだい
文句	もんく
振り返る	ふりかえる
知恵	ちえ
感じる	かんじる
大谷	おおたに
山田	やまだ
我慢	がまん
木村	きむら
台	だい
西山	にしやま
性質	せいしつ
浅い	あさい
素直	すなお
信じる	しんじる
長島	ながしま
大嫌い	だいきらい
ずるい	ずるい
浦島太郎	うらしまたろう
浜辺	はまべ
騒ぐ	さわぐ
亀	かめ
匹	ひき
捕まる	つかまる
転がす	ころがす
叩く	たたく
可哀相	かわいそう
そんなら	そんなら
買い取る	かいとる
撫でる	なでる
放す	はなす
釣	つり
ひょっこりと	ひょっこりと
お辞儀	おじぎ
龍宮	りゅうぐう
鯛	たい
比目魚	ひらめ
御殿	ごてん
通す	とおす
玉	ぎょく
貝	かい
眩しい	まぶしい
乙姫	おとひめ
暇	いとま
頻りに	しきりに
箱	はこ
抱える	かかえる
村	むら
どうかなる	どうかなる
煙	けむり
すうと	すうと
髪	かみ
真っ白	まっしろ
留守番	るすばん
留守番電話	るすばんでんわ
ドラマ	ドラマ
不愉快	ふゆかい
事務的	じむてき
伝言	でんごん
従う	したがう
返事	へんじ
アナウンサー	アナウンサー
話しかける	はなしかける
魅力	みりょく
比較	ひかく
同時性	どうじせい
逆戻り	ぎゃくもどり
男性	だんせい
女性	じょせい
もしもし	もしもし
山下	やました
川上	かわかみ
信号音	しんごうおん
以内	いない
羨ましい	うらやましい
夫	おっと
妻	つま
ねえ	ねえ
共働き	ともばたらき
減る	へる
テレビ電話	テレビでんわ
アフリカ	アフリカ
中継	ちゅうけい
スクリーン	スクリーン
真っ黒	まっくろ
黒人	こくじん
真っ赤	まっか
ぱくぱく	ぱくぱく
だが	だが
さっぱり	さっぱり
聞き返す	ききかえす
一層	いっそう
早口	はやくち
巻し立てる	まくしたてる
試す	ためす
弱る	よわる
どうやら	どうやら
スワヒリ語	スワヒリご
インドネシア	インドネシア
首をひねる	くびをひねる
ふと	ふと
思い付く	おもいつく
ホーム	ホーム
電子頭脳	でんしずのう
装置	そうち
ランプ	ランプ
ぱちぱち	ぱちぱち
瞬く	またたく
スピーカー	スピーカー
踊りあがる	おどりあがる
ダイヤル	ダイヤル
捻る	ひねる
連結	れんけつ
輝く	かがやく
流暢	りゅうちょう
回路	かいろ
共和国	きょうわこく
親友	しんゆう
うなずく	うなずく
会館	かいかん
行き先	ゆきさき
せき込む	せきこむ
南極市	なんきょくし
ロケット機	ロケットき
眉をひそめる	まゆをひそめる
輝かす	かがやかす
コピー	コピー
出回る	でまわる
サラダオイル	サラダオイル
イクラ	イクラ
材料	ざいりょう
上等	じょうとう
高度	こうど
加工	かこう
香り	かおり
歯ざわり	はざわり
そっくり	そっくり
食品添加物	しょくひんてんかぶつ
大量	たいりょう
合成	ごうせい
保存料	ほぞんりょう
給食	きゅうしょく
外食	がいしょく
骨	ほね
偽物	にせもの
苦しめる	くるしめる
奢り	おごり
へえ	へえ
流行り	はやり
素人	しろうと
フライ	フライ
ステーキ	ステーキ
もくもくと	もくもくと
長男	ちょうなん
孝司	たかし
突然	とつぜん
フォーク	フォーク
一切れ	ひときれ
だって	だって
チューブ	チューブ
入り	いり
ゼリー	ゼリー
錠剤	じょうざい
粒	つぶ
注射	ちゅうしゃ
未来	みらい
味わう	あじわう
噛む	かむ
屁理屈	へりくつ
コンコルド	コンコルド
ロッキード	ロッキード
SST	SST
じゃんじゃん	じゃんじゃん
エアカー	エアカー
歩道	ほどう
実用	じつよう
かっこいい	かっこいい
真面目くさい	まじめくさる
最も	もっとも
少年	しょうねん
大問題	だいもんだい
挿し込む	さしこむ
身分証明書	みぶんしょうめいしょ
支払い	しはらい
兼ねる	かねる
額	がく
実に	じつに
落とす	おとす
泥棒	どろぼう
札	さつ
無駄遣い	むだづかい
投書	とうしょ
目の前	めのまえ
貨幣	かへい
実感	じっかん
節約	せつやく
気楽	きらく
理性	りせい
行動	こうどう
知人	ちじん
ハンドバッグ	ハンドバッグ
テレフォンカード	テレフォンカード
意志	いし
弱い	よわい
夫婦	ふうふ
消費税	しょうひぜい
面倒	めんどう
玉	たま
コーヒーカップ	コーヒーカップ
偉い	えらい
給与	きゅうよ
口座	こうざ
丸井	まるい
使い過ぎ	つかいすぎ
特典	とくてん
改めて	あらためて
会員誌	かいいんし
裏	うら
マーク	マーク
飲食	いんしょく
乃至	ないし
割り引く	わりびく
会費	かいひ
勘違い	かんちがい
どうか	どうか
勇気	ゆうき
仕掛け人	しかけにん
飲食店	いんしょくてん
レジャー	レジャー
加盟店	かめいてん
加盟料	かめいひ
ステッカー	ステッカー
優待	ゆうたい
開拓	かいたく
経費	けいひ
クレジット	クレジット
他社	たしゃ
差がつく	さがつく
PR効果	PRこうか
自画自賛	じがじさん
店側	みせがわ
手数料	てすうりょう
限度	げんど
見劣りがする	みおとりがする
国内	こくない
地球	ちきゅう
半日	はんにち
感じ	かんじ
距離	きょり
移動	いどう
沿線	えんせん
次第	しだい
目的地	もくてきち
興奮	こうふん
高速化	こうそくか
火加減	ひかげん
煮込む	にこむ
電子レンジ	でんしレンジ
僅か	わずか
数分	すうふん
味見	あじみ
台所	だいところ
わくわく	わくわく
追求	ついきゅう
減少	げんしょう
繋がる	つながる
普及	ふきゅう
月給日	げっきゅうび
月給袋	げっきゅうふくろ
ボーナス	ボーナス
厚い	あつい
性格	せいかく
当然	とうぜん
失う	うしなう
懐かしい	なつかしい
竹井	たけい
乗り継ぎ	のりつぎ
なんだか	なんだか
窓際	まどぎわ
区別がつく	くべつがつく
贅沢	ぜいたく
不満	ふまん
どうのこうの	どうのこうの
感激	かんげき
初月給	はつげっきゅう
そうそう	そうそう
神棚	かみだな
供える	そなえる
勤	つとむ
結晶	けっしょう
明細書	めいさいしょ
道理で	どうりで
抜く	ぬく
数える	かぞえる
立体	りったい
靖	やすし
哲夫	てつお
ちらりと	ちらりと
目をやる	めをやる
ひそひそ	ひそひそ
許す	ゆるす
にっこり	にっこり
ただし	ただし
着	ちゃく
ジャンボジェット機	ジャンボジェットき
振る	ふる
スイッチ	スイッチ
想像	そうぞう
便	びん
運賃	うんちん
ばかにならない	ばかにならない
交通機関	こうつうきかん
比べ物にならない	くらべものにならない
何も	なにも
インスタント	インスタント
ラーメン	ラーメン
爆発的	ばくはつてき
小麦粉	こむぎこ
ヒット	ヒット
予想	よそう
要因	よういん
第一次	だいいちじ
愛用	あいよう
影響力	えいきょうりょく
コマーシャル	コマーシャル
民間	みんかん
スポットコマーシャル	スポットコマシャール
袋	ふくろ
足らず	たらず
秒	びょう
登場	とうじょう
購買欲	こうばいよく
そそる	そそる
挙って	こぞって
テレビスポット	テレビスポット
調査	ちょうさ
食	しょく
消費	しょうひ
まさに	まさに
蕎麦	そば
現れる	あらわれる
進出	しんしゅつ
即席めん	そくせきめん
レトルト	レトルト
飽きる	あきる
栄養	えいよう
偏る	かたよる
出前	でまえ
文字通り	もじどおり
お湯	おゆ
防腐剤	ぼうふざい
調理	ちょうり
手作り	てづくり
バランス	バランス
ライフスタイル	ライフスタイル
間食	かんしょく
夜食	やしょく
脂肪	しぼう
糖分	とうぶん
肥満	ひまん
太る	ふとる
忠告	ちゅうこく
農民	のうみん
町人	ちょうにん
名	な
戸籍簿	こせきぼ
名字	みょうじ
半助	はんずけ
正式	せいしき
商人	しょうにん
有力者	ゆうりょくしゃ
帯刀	たいとう
名誉	めいよ
けしからん	けしからん
身分	みぶん
尤も	もっとも
大地主	おおじぬし
小作人	こさくにん
習わし	ならわし
進んで	すすんで
重ねて	かさねて
命令	めいれい
村役場	むらやくば
松	まつ
山口	やまぐち
酒伊	さかい
本多	ほんだ
地名	ちめい
手掛かり	てがかり
ブーム	ブーム
漫画コミックス	まんがコミックス
近年	きんねん
年間	ねんかん
背景	はいけい
年齢	ねんれい
読者	どくしゃ
対象	たいしょう
売れ行き	うれゆき
読物	よみもの
上昇	じょうしょう
発行	はっこう
単行本	たんこうぼん
月間	げっかん
部数	ぶすう
出版物	しゅっぱんぶつ
与える	あたえる
情報	じょうほう
伝達	でんたつ
スピーチコンテスト	スピーチコンテスト
束の間	つかのま
空想	くうそう
浸る	ひたる
手段	しゅだん
さすが	さすが
気分転換	きぶんてんかん
骨休め	ほねやすめ
参考書	さんこうしょ
活字	かつじ
得る	える
訓練	くんれん
場所	ばしょ
形成	けいせい
人生観	じんせいかん
現実	げんじつ
生き抜く	いきぬく
疑問	ぎもん
現象	げんしょう
当分	とうぶん
功罪	こうざい
分析	ぶんせき
一目	ひとめ
現代	げんだい
受ける	うける
主催	しゅさい
開会	かいかい
埋まる	うずまる
聴衆	ちょうしゅう
主催者	しゅさいし
未満	みまん
満たす	みたす
使い慣れる	つかいなれる
認識	にんしき
絶好	ぜっこう
趣旨	しゅし
いよいよ	いよいよ
演壇	えんだん
インド	インド
次々に	つぎつぎに
熱弁	ねつべん
奮う	ふるう
聊か	いささか
まごつく	まごつく
ユーモラス	ユーモラス
自国	じこく
引き付ける	ひきつける
結論	けつろん
拍手	はくしゅ
わき起こる	わきおこる
ほっと	ほっと
審査	しんさ
甲斐	かい
入賞	にゅうしょう
専門用語	せんもんようご
数字	すうじ
賞品	しょうひん
授与	じゅよ
講評	こうひょう
順位	じゅんい
集計	しゅうけい
減点	げんてん
張り切る	はりきる
マスコミ	マスコミ
全国紙	ぜんこくし
地方紙	ちほうし
地方紙	せんもんし
日刊	にっかん
あたり	あたり
オリンピック	オリンピック
メーカー	メーカー
離れる	はなれる
ポスター	ポスター
ディスカバージャパン	ディスカバージャパン
見かける	みかける
クール	クール
タッチ	タッチ
ハード	ハード
アクション	アクション
直接	ちょくせつ
ナポレオンソロ	ナポレオンソロ
押し付けがましい	おしつけがましい
混乱	こんらん
金メダル	きんメダル
ヨットレース	ヨットレース
相模湾	さがみわん
誇る	ほこる
ハヤマ号	ハヤマごう
キエル	キエル
ラース	ラース
ベテラン	ベテラン
選手	せんしゅ
スリグ	スリグ
スタート	スタート
隻	せき
ヨット	ヨット
波	なみ
先頭	せんとう
グラフ	グラフ
びくとも	びくとも
コース	コース
艇	てい
傾く	かたむく
支えづな	ささえづな
乗り出す	のりだす
迫る	せまる
はっと	はっと
仰向け	あおむけ
帆	ほ
あっと言う間に	あっというまに
放り出す	ほうりだす
波間	なみま
消える	きえる
マスト	マスト
へばり付く	へばりつく
命	いのち
急旋回	きゅうせんかい
風速	ふうそく
煽る	あおる
横倒し	よこだおし
しまった	しまった
真っ青	まっさお
たちまち	たちまち
通り抜ける	とおりぬける
トッサニ	とっさに
勝つ	かつ
走り抜ける	はしりぬける
俺たち	おれたち
役目	やくめ
晒す	さらす
見過ごす	みすごす
一瞬	いっしゅん
行きかう	ゆくかう
見合わせる	みあわせる
ちらっと	ちらっと
中断	ちゅうだん
巧み	たくみ
バック	バック
揉む	もむ
さっと	さっと
ロープ	ロープ
無事	ぶじ
救助	きゅうじょ
送り届ける	おくりとどける
再び	ふたたび
終に	ついに
駆け寄る	かけよる
ヨットマン	ヨットマン
誇り	ほこり
誉め称える	ほめたたえる
入場券	にゅうじょうけん
見回す	みまわす
見つかる	みつかる
映る	うつる
劇映画	げきえいが
女優	じょゆう
筋	すじ
所々	ところどころ
上映	じょうえい
ヒロイン	ヒロイン
演じる	えんじる
役	やく
魅力的	みりょくてき
賞	しょう
男優	だんゆう
父親	ちちおや
いかにも	いかにも
ストーリー	ストーリー
天平	てんぴょう
いらか	いらか
シナリオ	シナリオ
ナレーション	ナレーション
唐	とう
高僧	こうそう
留学僧	りゅうがくそう
一行	いっこう
揚州	ようしゅう
雲綱	うんこう
普照	ふしょう
上がる	あがる
外国人	がいこくじん
群れ	むれ
道抗	どうこう
立ち止まる	たちどまる
指す	さす
大明寺	だいめいじ
鑑真	がんじん
居間	いま
混天儀	こんてんぎ
博学	はくがく
伺う	うかがう
香炉	こうろ
緩やか	ゆるやか
漂う	ただよう
経典	けいてん
綬解く	ひもとく
僧	そう
栄叡	ようえい
同じく	おなじく
奈良	なら
大安寺	だいあんじ
興福寺	こうふくじ
玄郎	げんろう
修行	しゅぎょう
弟子	でし
推薦	すいせん
控える	ひかえる
長老	ちょうろう
座	ざ
ほの暗い	ほのぐらい
重苦しい	おもくるしい
沈黙	ちんもく
支配	しはい
祥彦	しょうえん
辿り着く	たどりつく
徳清	とくせい
緊張	きんちょう
口をつぐむ	くちをつぐむ
語りかける	かたりかける
お前	おまえ
求法	ぐほう
燃える	もえる
目指す	めざす
旅立つ	たびだつ
仏典	ぶってん
授戒師	じゅかいし
応える	こたえる
戒律	かいりつ
法	ほう
左右	さゆう
顧みる	かえりみる
息を飲む	いきをのむ
注ぐ	そそぐ
口を開く	くちをひらく
恐れる	おそれる
思いがけない	おもいがけない
垂れる	たれる
普及率	ふきゅうりつ
高まる	たかまる
膨大	ぼうだい
達する	たっする
トランジスターラジオ	トランジスターラジオ
実用化	じつようか
人種	じんしゅ
刺す	さす
重傷	じゅうしょう
負う	おう
真似る	まねる
一概に	いちがいに
どれほど	どれほど
われわれ	われわれ
結局	けっきょく
御者	ぎょしゃ
いろんな	いろんな
ギャング	ギャング
ごっこ	ごっこ
大けが	おおけが
漸く	ようやく
これだけ	これだけ
良かれ悪しかれ	よかれあしかれ
使いこなす	つかいこなす
賢い	かしこい
修繕	しゅうぜん
トランプ	トランプ
一学期	いちがっき
何となく	なんとなく
つい	つい
奴隷	どれい
大活躍	だいかつやく
人物	じんぶつ
はらはら	はらはら
動き	うごき
図	ず
望遠鏡	ぼうえんきょう
放送局	ほうそうきょく
殺す	ころす
歌謡曲	かようきょく
キャーキャー	キャーキャー
極	きょく
寝不足	ねぶそく
視力	しりょく
眠たい	ねむたい
衰える	おとろえる
っぱなし	っぱなし
パチンパチン	パチンパチン
引き回す	ひきまわす
計画的	けいかくてき
パチット	パチット
スイッチを切る	スイッチをきる
積極的	せっきょくてき
ながら族	ながらぞく
完全	かんぜん
一度	いちど
癖	くせ
いずれにせよ	いずれにせよ
ボリューム	ボリューム
親父	おやじ
とうてい	とうてい
奴	やつ
鶴	つる
恩返し	おんがえし
字幕	じまく
画面	がめん
村はずれ	むらはずれ
語り手	かたりて
ふたり暮らし	ふたりぐらし
薪	たきぎ
農夫	のうふ
けたたましい	けたたましい
鳴き声	なきごえ
前方	ぜんぽう
罠	わな
罠にかかる	わなにかかる
救い	すくい
羽ばたき	はばたき
よしよし	よしよし
外る	はずる
羽ばたく	はばたく
見送る	みおくる
薄暗い	うすぐらい
土間	どま
縄	なわ
なう	なう
炉辺	ろばた
縫い物	ぬいもの
とも	とも
無言	むごん
囲炉裏	いろり
ちょろちょろ	ちょろちょろ
夜更け	よふけ
はあい	はあい
戸	と
蓑	みの
泊める	とめる
荒屋	あばらや
まあまあ	まあまあ
さあさあ	さあさあ
甘える	あまえる
明くる	あくる
忠実忠実しい	まめまめしい
親戚	しんせき
いっそ	いっそ
貧乏	びんぼう
手をつく	てをつく
機	はた
織る	おる
機織り場	はたおりば
わし	わし
小屋	こや
トンカラリ	トンカラリ
匹	ひき
差し出す	さしだす
何と	なんと
見事	みごと
織物	おりもの
綾錦	あやにしき
こっそり	こっそり
そっと	そっと
転がす	ころがす
駆け戻る	かけもどる
ペタント	ぺたんと
おい	おい
何で	なんで
胸	むね
正体	しょうたい
達者	たっしゃ
ひと声	ひとごえ
夕もや	ゆうもや
